ishla/yotgan	ishla	ishl
yangi/	yangi	yang
yagona/	yagona	yagoa
haqda/	haqda	haqa
alohida/	alohida	alohd
yuqori/	yuqori	yuqor
haq/i	haq	haqi
yara/tish	yara	yarat
imkon/ini	imkon	imko
dey/iladi	dey	deyil
hamda/	hamda	ham
qutq/arish	qutq	qutqr
top/ildi	top	topi
ish/lab	ish	ishla
dollar/	dollar	doll
kir/itgan	kir	kiri
jumla/dan	jumla	juml
o‘n/lab	o‘n	o‘na
kel/ingan	kel	keli
old/ini	old	oldi
tomon/idan	tomon	tomo
miso/l	miso	misol
kir/itish	kir	kirit
barav/ar	barav	barava
hali/	hali	hal
zar/ar	zar	zara
yetkaz/ib	yetkaz	yetkz
o‘zgarish/ining	o‘zgarish	o‘zgrsh
bir/inchi	bir	birih
yosh/li	yosh	yoshli
yigit/	yigit	yigt
qil/inayotgan	qil	qili
ushla/ngan	ushla	ushl
avva/l	avva	avval
shimol/idagi	shimol	shimo
tufayli/	tufayli	tufay
joy/ida	joy	joya
sod/ir	sod	sodr
joy/idan	joy	joya
iz/lar	iz	iza
top/ilgan	top	topi
iz/lari	iz	izar
tashqari/	tashqari	tashqar
usul/i	usul	usu
qil/indi	qil	qili
xavf/li	xavf	xavfl
orqali/	orqali	orqal
ko‘p/roq	ko‘p	ko‘pr
ber/ilgan	ber	berl
buyurtma/	buyurtma	buyurtm
tajriba/	tajriba	tajrba
tanla/b	tanla	tana
katta/	katta	katt
turtki/	turtki	turtk
bo‘yicha/	bo‘yicha	bo‘yich
chiqindi/	chiqindi	chiqind
chiqar/ishni	chiqar	chiq
sezilar/li	sezilar	seziar
hissa/	hissa	his
foydalan/ish	foydalan	foydalanh
to‘g‘ri/dan	to‘g‘ri	to‘g‘r
sayyora/ga	sayyora	sayyor
kes/iladi	kes	kesila
chiq/aradi	chiq	chiqar
muqobil/	muqobil	muqobl
yet/ishtirish	yet	yetii
chiq/aruvchi	chiq	chiqaruv
bo‘lag/i	bo‘lag	bo‘lg
tafsilot/larini	tafsilot	tafsiot
sumka/si	sumka	sumk
osil/gan	osil	osi
holda/	holda	hol
top/ilgani	top	topi
atal/gan	atal	ata
ko‘l/ining	ko‘l	ko‘li
haf/tagacha	haf	hafa
ush/lab	ush	usha
bos/imning	bos	bosi
haqida/	haqida	haqid
ayt/ilgandi	ayt	aytil
qanday/	qanday	qandy
ayt/ildi	ayt	ayti
milliard/	milliard	millird
oqs/il	oqs	oqsl
raqam/li	raqam	raqa
ishla/yotganini	ishla	ishl
osh/irish	osh	oshir
osh/irishi	osh	oshir
asosan/	asosan	asoan
qytgan/	qytgan	qyt
chegarachi/lari	chegarachi	chegrachi
narkotik/	narkotik	narkotk
mod/da	mod	modda
ol/di	ol	old
chegara/	chegara	chegra
otrya/di	otrya	otry
chegara/dan	chegara	chegra
kechiril/ganda	kechiril	kechr
modda/si	modda	modd
gashish/	gashish	gashsh
borlig/i	borlig	borlg
tegishli/	tegishli	tegshli
qimmat/	qimmat	qimmt
poytaxt/	poytaxt	poytxt
kassa/	kassa	kass
ricci/	ricci	ricc
shu/ndan	shu	shun
chang‘i/	chang‘i	chang‘
sailer/	sailer	saier
muhokama/	muhokama	muhokam
qilin/ayotgani	qilin	qili
to‘ntar/ishi	to‘ntar	to‘nt
top/ilganini	top	topi
tog‘/li	tog‘	tog‘l
so‘z/lariga	so‘z	so‘za
ming/lab	ming	mingl
bo‘l/maganda	bo‘l	bo‘la
ishonch/i	ishonch	ishochi
komil/	komil	koml
qisqa/	qisqa	qisq
aniq/lab	aniq	aniql
qilmish/larni	qilmish	qilmsh
tomon/i	tomon	tomo
shu/ning	shu	shuni
bedarak/	bedarak	bedrak
haqida/gi	haqida	haqid
bo‘la/	bo‘la	bo‘l
qayta/	qayta	qayt
ur/ingan	ur	urn
erish/ilgan	erish	erih
vatan/iga	vatan	vatai
qaytar/ishga	qaytar	qayt
kel/ishgan	kel	keli
foizlik/	foizlik	foizlk
oldin/dan	oldin	oldi
chiq/ilayotganini	chiq	chiqi
o‘z/ining	o‘z	o‘zi
esla/tib	esla	eslat
o‘t/amiz	o‘t	o‘ta
band/iga	band	ban
hamma/	hamma	hamm
qiymat/ining	qiymat	qiymt
kam/ida	kam	kami
isteʼmolch/iga	isteʼmolch	isteʼmolchi
qadar/	qadar	qadr
o‘z/i	o‘z	o‘zi
pul/i	pul	puli
oy/lab	oy	oyla
qaysi/	qaysi	qays
belgi/lab	belgi	belg
ayt/ishingiz	ayt	ayti
qonun/ga	qonun	qonu
tovar/	tovar	tovr
tartib/i	tartib	tartb
binoan/	binoan	binoa
narsa/si	narsa	nars
muhim/	muhim	muh
ur/inib	ur	urn
endi/	endi	end
band/ini	band	ban
belgila/ysiz	belgila	belgil
o‘shanda/	o‘shanda	o‘shand
olding/i	olding	oldig
chorshanba/	chorshanba	chorshanb
brif/ingda	brif	brifi
deya/	deya	dey
muxbir/i	muxbir	muxbr
dollar/ni	dollar	doll
yil/ning	yil	yiln
dollar/ga	dollar	dollr
ko‘rsatkich/	ko‘rsatkich	ko‘r
qiymat/i	qiymat	qiymt
osh/irish	osh	oshir
quvvat/i	quvvat	quvvati
tonna/dan	tonna	tonn
osh/irildi	osh	oshr
vakil/ining	vakil	vakili
to‘xtat/gandi	to‘xtat	to‘xta
top/ilishi	top	topi
banknot/	banknot	bankot
munosabat/	munosabat	munosbat
kir/itilganining	kir	kiri
yillig/i	yillig	yillg
munosabat/i	munosabat	munosbat
raqam/i	raqam	raqa
namuna/	namuna	namun
belgi/si	belgi	belgs
belgi/lari	belgi	belgir
qil/inadi	qil	qili
balki/	balki	balk
qiymat/	qiymat	qiymt
chiq/armaslik	chiq	chiqar
tarqat/maslik	tarqat	tarqata
kir/itilishi	kir	kiri
kut/ilayotgan	kut	kuti
gap/iga	gap	gapi
aylanma/si	aylanma	aylana
dollar/ini	dollar	dol
dollar/i	dollar	dol
aylanma/sida	aylanma	aylana
ravishda/	ravishda	ravishd
aylanma/sining	aylanma	aylana
xissa/siga	xissa	xiss
bartaraf/	bartaraf	bartra
ikkala/	ikkala	ikkal
o‘yla/b	o‘yla	o‘ya
tannarx/ining	tannarx	tannr
xuddi/	xuddi	xud
voqean/i	voqean	voqea
barqaror/	barqaror	barqror
nar/sa	nar	nars
muhit/i	muhit	muht
kursi/ni	kursi	kur
beri/	beri	ber
reyting/ida	reyting	reytng
kir/itsa	kir	kiri
bo‘l/masa	bo‘l	bo‘la
qur/ilishi	qur	qurl
daromad/	daromad	daromd
ko‘tar/iladi	ko‘tar	ko‘tr
qara/tiladi	qara	qarat
farq/li	farq	farql
o‘laroq/	o‘laroq	o‘larq
yasha/sh	yasha	yashas
o‘rta/cha	o‘rta	o‘rtah
dekabr/	dekabr	dekbr
andi/jon	andi	andion
poytaxt/ning	poytaxt	poytxt
yillik/	yillik	yillk
foiz/li	foiz	foizl
atigi/	atigi	atig
yarim/	yarim	yari
shundak/i	shundak	shunak
xususan/	xususan	xususn
taqdim/	taqdim	taqm
biriniinfinbank/	biriniinfinbank	biriniininak
maksima/l	maksima	maksmal
summa/si	summa	summ
usmonov/ga	usmonov	usmonv
rux/sat	rux	ruxa
vashington/	vashington	vashngton
qarshi/	qarshi	qarsh
transneft/	transneft	transnet
vashington/ning	vashington	vashngton
vladim/ir	vladim	vlaim
tadbirkor/larning	tadbirkor	tadbrkor
boylig/i	boylig	boylg
aytilgand/	aytilgand	aytld
ko‘rin/ishga	ko‘rin	ko‘ri
yax/taga	yax	yaxt
yaxta/ni	yaxta	yaxt
nomla/gan	nomla	noml
yaxta/	yaxta	yaxt
vaqt/ning	vaqt	vaqti
sig‘dira/	sig‘dira	sig‘dra
qol/dirgan	qol	qolr
bun/gacha	bun	bunh
tonna/	tonna	tonn
yaxta/ning	yaxta	yaxt
de/ngiz	de	den
abramovich/ning	abramovich	abramvich
egalla/gan	egalla	egall
dize/l	dize	dizel
tizim/i	tizim	tiz
erisha/	erisha	era
deyarli/	deyarli	deyrl
qur/ilgan	qur	qurl
dilbaraz/gan	dilbaraz	dilbraz
tadbir/da	tadbir	tadbr
ferma/	ferma	ferm
sapfir/	sapfir	sapfr
ishonchi/ni	ishonchi	ishochi
izchi/l	izchi	izch
investitsiyaviy/	investitsiyaviy	investitsiyavi
cheklov/lariga	cheklov	cheklv
to‘xta/ldi	to‘xta	to‘xtal
ol/dik	ol	oli
maqsad/imiz	maqsad	maqsd
kelgusi/	kelgusi	kelgus
yetkaz/ish	yetkaz	yetkz
zamin/	zamin	zamn
ishonch/	ishonch	ishoch
qur/ilish	qur	qurl
dollarlik/	dollarlik	dolllik
ol/inishi	ol	oln
chaq/irdi	chaq	chaqir
imkoniyat/lar	imkoniyat	imkoiyat
xari/tasi	xari	xaria
vazir/ining	vazir	vaziri
maro/simi	maro	maros
usmonov/dan	usmonov	usmonv
voqeal/ar	voqeal	voqealar
duma/sining	duma	dum
villa/	villa	vill
solovy/ov	solovy	solovyo
ayr/ilgan	ayr	ayril
sardiniya/da	sardiniya	sardinya
gennadiy/	gennadiy	genndiy
ega/si	ega	egai
musodara/	musodara	musodra
remoda/da	remoda	remod
mojaro/ning	mojaro	mojaron
tahlil/ini	tahlil	tahli
urush/ining	urush	urushi
tahl/il	tahl	tahli
kerakki/	kerakki	kerakk
rivojla/nmoqda	rivojla	rivojlan
kavkaz/	kavkaz	kavkz
makkajo‘xor/i	makkajo‘xor	makkajo‘or
bosq/ini	bosq	bosqi
ber/ilgandi	ber	berl
yo‘qotganlik/	yo‘qotganlik	yo‘qotgnlik
nogiro/ni	nogiro	nogiron
ilgari/	ilgari	ilgr
nogiron/lariga	nogiron	nogion
to‘la/nishi	to‘la	to‘l
belgila/ngan	belgila	belgla
belgila/ndi	belgila	belglan
taʼtilinitaj/iga	taʼtilinitaj	taʼtilinita
auktsion/	auktsion	auktson
beril/ganda	beril	berl
taʼl/im	taʼl	taʼli
muassasa/si	muassasa	muassas
kir/itishi	kir	kirit
soat/gacha	soat	soata
belgila/ngani	belgila	belgla
kechira/	kechira	kechra
borada/	borada	bor
tanqid/	tanqid	tanqd
tramvay/	tramvay	travay
golland/	golland	gollnd
havf/sizligi	havf	havfl
kishi/	kishi	kish
hodi/salar	hodi	hodisa
nafar/	nafar	nafa
ythlar/i	ythlar	ythr
ol/insa	ol	oln
nafar/ining	nafar	nafari
yaʼni/	yaʼni	yaʼn
karra/siga	karra	karras
ko‘cha/larga	ko‘cha	ko‘chal
piyoda/lar	piyoda	piyoa
etila/	etila	eti
boshla/ndi	boshla	boshlan
soha/da	soha	soh
raqa/mlar	raqa	raqaa
qil/inishi	qil	qilin
loz/im	loz	lozi
ber/iladi	ber	berl
xulo/sa	xulo	xulos
qada/m	qada	qad
to‘g‘rladi/gan	to‘g‘rladi	to‘g‘rldi
turli/cha	turli	turi
chiq/ishdan	chiq	chiqi
havf/li	havf	havfl
yetar/li	yetar	yetr
metall/	metall	metal
xavf/sizligi	xavf	xavfl
namoyish/	namoyish	namoyis
tuzu/lishini	tuzu	tuzul
chiq/qan	chiq	chiqa
yo‘lag/ining	yo‘lag	yo‘lg
ayla/nishi	ayla	aylan
shah/ar	shah	shahar
qad/im	qad	qadi
boshla/di	boshla	boshl
etil/ganidek	etil	eti
voqeaga/	voqeaga	voqeaa
ythlar/ida	ythlar	ythar
bo‘l/indi	bo‘l	bo‘li
samara/li	samara	samaral
ol/adigan	ol	oli
yara/ta	yara	yarat
hari/tadan	hari	harita
harakatlan/ish	harakatlan	harakatla
tomon/dan	tomon	tomo
mun/cha	mun	muna
arzon/ga	arzon	arzo
gollandiab/	gollandiab	gollandia
yoz/ilayotgan	yoz	yozi
shaharlaridagi/dan	shaharlaridagi	shaharlaridai
o‘li/shiga	o‘li	o‘l
tizim/	tizim	tizm
vak/il	vak	vakil
tarbiyachi/si	tarbiyachi	tarbiyach
ishlat/ib	ishlat	ishla
tasdiqla/gan	tasdiqla	tasdiql
tir/sak	tir	tira
yet/kazgan	yet	yeta
dor/i	dor	dori
ber/ilishi	ber	berl
ish/dan	ish	isha
taʼl/imi	taʼl	taʼli
ayt/ilgan	ayt	aytil
ol/ing	ol	oln
tuman/i	tuman	tuma
qashqadaryo/	qashqadaryo	qashqadryo
ber/ilgani	ber	berl
mas/ala	mas	masala
ernazar/ov	ernazar	ernazr
borasida/	borasida	bora
ajra/tish	ajra	ajrat
etila/ni	etila	etla
madaniy/	madaniy	madaiy
etil/ayotgani	etil	et
maska/ni	maska	maskan
yuqoridagi/larni	yuqoridagi	yuqoridgi
o‘rin/da	o‘rin	o‘ri
or/ganlari	or	org
takomilla/shtirish	takomilla	takomillah
berilg/	berilg	berg
yotq/izish	yotq	yotqi
reja/li	reja	rejal
tartib/ga	tartib	tartb
ko‘chalar/igacha	ko‘chalar	ko‘chalr
rahb/ar	rahb	rahba
lavozim/iga	lavozim	lavozm
xalqaro/	xalqaro	xalqro
faol/lari	faol	faola
ruh/da	ruh	ruha
yig‘il/ishda	yig‘il	yig‘
mutasad/dilar	mutasad	mutasaddi
joy/iga	joy	joya
o‘qi/ldi	o‘qi	o‘qil
oila/sidan	oila	oil
qiz/i	qiz	qizi
kecha/larda	kecha	kechar
qorin/	qorin	qori
et/kazadi	et	eta
o‘t/ilgan	o‘t	o‘til
tingla/di	tingla	tingl
bo‘lganlig/i	bo‘lganlig	bo‘lgalig
hamma/si	hamma	hamm
tingla/gan	tingla	tingl
rais/li	rais	raisl
kir/itganlar	kir	kiritn
o‘tkazilmoqd/	o‘tkazilmoqd	o‘tkazilmo
firibgar/lar	firibgar	firibgr
maydon/ini	maydon	maydo
oltiariq/	oltiariq	oltiriq
kiritganlig/i	kiritganlig	kiritanlig
dal/il	dal	dalil
firibgarlik/	firibgarlik	firibgrlik
o‘tkaz/ilmoqda	o‘tkaz	o‘tkazi
ahol/iga	ahol	aholi
qilganlig/i	qilganlig	qilglig
filial/idan	filial	filia
shoh/li	shoh	shohl
filial/i	filial	filia
rahbar/ining	rahbar	rahbr
erish/ib	erish	ersh
qilganlik/lari	qilganlik	qilglik
o‘zla/shtirish	o‘zla	o‘zlah
yash/irib	yash	yashi
xizmat/ining	xizmat	xizmt
yo‘lag/i	yo‘lag	yo‘lg
kechir/ilganida	kechir	kechi
rang/li	rang	rangl
yashiana/	yashiana	yashian
qil/inmagan	qil	qili
et/tirilmoqda	et	eti
muqaddam/	muqaddam	muqddam
etganlig/i	etganlig	etgnlig
sudlan/ib	sudlan	sudla
jazo/sini	jazo	jazoi
ket/ilgan	ket	ketil
manzil/ga	manzil	manzi
yo‘nalish/ida	yo‘nalish	yo‘nah
nuq/ta	nuq	nuqta
maqsad/	maqsad	maqsd
ber/ishgan	ber	beri
tayinla/	tayinla	tayin
qotil/i	qotil	qot
top/ilganligi	top	topi
apre/l	apre	aprel
ko‘r/satmasida	ko‘r	ko‘ra
ketganlig/i	ketganlig	ketglig
bo‘l/ganida	bo‘l	bo‘la
tag/idagi	tag	tagi
dollar/iga	dollar	dollr
savdola/shadi	savdola	savdoa
qilin/ishiga	qilin	qili
bo‘linma/si	bo‘linma	bo‘linm
xodim/iga	xodim	xodm
qonuniy/	qonuniy	qonuiy
qoidabuzarlig/i	qoidabuzarlig	qoidabuzarli
maydon/idan	maydon	maydo
yo‘nalish/iga	yo‘nalish	yo‘nah
fakultet/iga	fakultet	fakulteti
yuzasid/	yuzasid	yuzad
oydinlik/	oydinlik	oydinik
sevimli/	sevimli	sevim
chal/inib	chal	chali
uyla/ntirgan	uyla	uylan
aktrisa/	aktrisa	aktris
baxt/li	baxt	baxtl
sarmast/	sarmast	sarmst
bil/asizmi	bil	bila
kelin/im	kelin	keli
shohista/ning	shohista	shohist
ayt/ilmagan	ayt	aytil
ayt/aman	ayt	ayta
baraka/	baraka	barak
top/sin	top	topi
ko‘ngli/mizni	ko‘ngli	ko‘ngi
chaqaloq/ni	chaqaloq	chaqaoq
ekan/ingizdan	ekan	ekani
o‘g‘l/imni	o‘g‘l	o‘g‘li
kelin/imdan	kelin	keli
qilma/yman	qilma	qilm
erkinlik/	erkinlik	erkilik
birgalik/da	birgalik	birgaik
hamma/siga	hamma	hamm
qayno/ta	qayno	qaynoa
hoz/ir	hoz	hozi
ayt/ishicha	ayt	ayti
kelin/ingiz	kelin	keli
tan/ir	tan	tani
ko‘r/aman	ko‘r	ko‘ra
kelin/imning	kelin	keli
boshlad/	boshlad	boshld
ona/sining	ona	onai
uyla/ndi	uyla	uyl
uylan/adigan	uylan	uyla
kelin/ga	kelin	keli
yoq/yapti	yoq	yoqa
kelin/imga	kelin	keli
sekin/gina	sekin	seki
hazillashyapsiz/mi	hazillashyapsiz	hazillashyaiz
ayt/ib	ayt	ayti
gap/irgan	gap	gapir
siyl/adi	siyl	siy
chal/inganimni	chal	chalin
munosabat/da	munosabat	munosbat
kasa/l	kasa	kasal
siz/dan	siz	siza
dard/li	dard	dardl
gazeta/si	gazeta	gazet
kema/lar	kema	kemal
festiva/li	festiva	festival
dengiz/ining	dengiz	dengzi
tan/itish	tan	tant
maqsad/i	maqsad	maqsd
yarat/iladi	yarat	yara
hindiston/	hindiston	hindston
ayni/	ayni	ayn
turish/ibdi	turish	tursh
o‘tkazild/	o‘tkazild	o‘tkazld
tanga/lar	tanga	tang
vazir/lar	vazir	vazira
o‘rganish/lari	o‘rganish	o‘rganih
vatan/imiz	vatan	vatani
bosh/lab	bosh	boshl
mero/si	mero	meros
lozimlig/i	lozimlig	lozimig
xazina/	xazina	xazia
parlamentlararo/	parlamentlararo	parlamentlara
qo‘mita/	qo‘mita	qo‘mit
bmtdagi/	bmtdagi	bmtag
kotib/i	kotib	kotb
palata/si	palata	palat
yaqin/dan	yaqin	yaqi
bemor/larning	bemor	bemorr
taqdir/i	taqdir	taqir
xaq/ida	xaq	xaqi
turdiboev/	turdiboev	turdboev
kartina/	kartina	kartn
oldin/da	oldin	oldi
saʼdiev/ning	saʼdiev	saʼiev
qismat/i	qismat	qismt
o‘t/ishi	o‘t	o‘ti
etish/lari	etish	eth
taʼkid/lab	taʼkid	taʼkidl
multimedia/	multimedia	multmedia
golografik/	golografik	golograik
kuch/larini	kuch	kuchl
et/tiradi	et	eti
bo‘ri/lar	bo‘ri	bo‘r
taʼkidl/adi	taʼkidl	taʼkidla
och/ilishi	och	ochl
joizk/i	joizk	joizki
qator/iga	qator	qatori
qo‘g‘irchoq/	qo‘g‘irchoq	qo‘g‘ircho
nasriddin/	nasriddin	nasrddn
bo‘lajak/	bo‘lajak	bo‘lajk
bil/im	bil	bilm
ettir/adilar	ettir	ettira
hayriya/	hayriya	hayriy
ko‘mag/ida	ko‘mag	ko‘mg
matkarimboy/	matkarimboy	matkarimoy
yo‘nalish/i	yo‘nalish	yo‘nalh
olis/	olis	oli
belgila/nmoqda	belgila	belgilan
bitta/sida	bitta	bit
kir/itiladi	kir	kiri
taqiqla/nmagan	taqiqla	taqiqlan
telekanal/i	telekanal	telekana
jamgarma/sining	jamgarma	jamgrma
jamgarma/si	jamgarma	jamgrma
jamgarma/	jamgarma	jamgrma
haar/igacha	haar	haari
tushir/adi	tushir	tushr
kel/inayotgan	kel	keli
taqdirla/nadi	taqdirla	taqdirl
ber/ilishini	ber	beril
ber/adigan	ber	berd
moljalla/ngan	moljalla	moljall
qaytar/iladi	qaytar	qayt
manzil/ida	manzil	manzi
muassasa/sida	muassasa	muassas
o‘zlashtirganlik/	o‘zlashtirganlik	o‘zlashtirgani
qiymat/ini	qiymat	qiymt
kvota/lari	kvota	kvoa
sara/lab	sara	saral
qimmat/i	qimmat	qimmt
norma/lari	norma	normar
ber/ilmoqda	ber	berl
muhit/	muhit	muht
halo/l	halo	halol
yetti/	yetti	yett
taqiqla/sh	taqiqla	taqiqa
tayyorgarlik/	tayyorgarlik	tayyorgrlik
or/ganlaridan	or	orn
qatna/shish	qatna	qatnash
modda/ning	modda	modd
kir/itildi	kir	kiri
ctlar/da	ctlar	ctlr
norma/larni	norma	normar
tuz/ilish	tuz	tuzl
etil/ayotganda	etil	etl
oshir/adigan	oshir	oshira
ishla/shini	ishla	ishlah
punktlar/i	punktlar	punktar
jihozla/sh	jihozla	jihoza
kundalik/	kundalik	kundaik
logistika/	logistika	logistka
ealqaro/	ealqaro	ealqro
afgoniston/	afgoniston	afgoiston
yuk/sak	yuk	yuka
baho/lab	baho	bahol
yangila/ngan	yangila	yangla
ertang/i	ertang	ertag
ishonchli/	ishonchli	ishochli
yara/tishi	yara	yarat
yo‘nal/ishga	yo‘nal	yo‘na
erkinlig/i	erkinlig	erkilig
yo‘nalish/	yo‘nalish	yo‘nalh
kidla/nib	kidla	kidl
norma/ni	norma	norm
yo‘nalish/dagi	yo‘nalish	yo‘nal
chiq/ishda	chiq	chiqi
keraklig/i	keraklig	kerakig
rivojla/nishi	rivojla	rivojan
belgila/sh	belgila	belgla
ko‘r/satishiga	ko‘r	ko‘ra
qara/tilgani	qara	qarat
qoida/	qoida	qoid
kir/itadi	kir	kiri
iroda/sining	iroda	irod
erta/	erta	ert
bor/ilayotgan	bor	boril
oshir/ilmoqda	oshir	oshi
test/lar	test	tes
radioto‘lqin/li	radioto‘lqin	radioto‘lin
ko‘lam/idan	ko‘lam	ko‘la
nima/larga	nima	nimal
javob/lari	javob	javoba
o‘rtoqla/shdi	o‘rtoqla	o‘rtoql
yur/ganda	yur	yura
kuchay/adi	kuchay	kuchaya
qarsilla/sh	qarsilla	qarsill
shish/ishi	shish	shsh
xastalik/	xastalik	xastalk
qiyinla/shadi	qiyinla	qiyina
etishmovchilig/i	etishmovchilig	etshmovchilig
kislorod/	kislorod	kislood
naz/ar	naz	naza
haq/dagi	haq	haqa
bor/ilishini	bor	boril
terapevt/	terapevt	terpevt
tan/ishadi	tan	tani
gazla/ngan	gazla	gazlan
savol/iga	savol	savoli
dosent/	dosent	doset
quyidagi/cha	quyidagi	quyidgi
bir/gina	bir	biri
erta/roq	erta	ert
o‘g‘il/	o‘g‘il	o‘g‘
bola/da	bola	bol
etishmovchilig/iga	etishmovchilig	etshmovchilig
tufayli/	tufayli	tufay
yo‘qot/iladi	yo‘qot	yo‘qo
organizm/	organizm	orgizm
ajra/lmay	ajra	ajral
qo‘lla/nilmasa	qo‘lla	qo‘llai
baʼzi/da	baʼzi	baʼz
tahdid/	tahdid	tahdd
reyting/ini	reyting	reytg
etil/sa	etil	etl
chek/ayotgan	chek	cheka
izdan/	izdan	izda
had/dan	had	hada
xavo/tir	xavo	xavoti
beqaror/	beqaror	beqror
besh/inchi	besh	beshi
dona/dan	dona	don
etishmovchilig/ini	etishmovchilig	etshmovchilig
parvar/ishida	parvar	parvari
yog‘/li	yog‘	yog‘l
kalta/	kalta	kalt
tara/ladi	tara	taral
qur/itish	qur	qurt
aqshni/ng	aqshni	aqshi
yara/tdi	yara	yarat
singari/	singari	singri
o‘simta/ni	o‘simta	o‘sima
osh/irdilar	osh	oshi
yor/iladi	yor	yori
qo‘llanila/	qo‘llanila	qo‘llania
erish/ilishiga	erish	ersh
yashirin/	yashirin	yashin
shtamm/	shtamm	shtam
tarq/ala	tarq	tarqaa
shtammda/	shtammda	shtammd
kuza/tilmaydi	kuza	kuzat
tayanib/	tayanib	tayab
shtammlar/ga	shtammlar	shtammlr
kech/ayotganini	kech	kecha
belgilar/siz	belgilar	belgilr
tasdiqlayd/	tasdiqlayd	tasdiqlay
xavf/ini	xavf	xavfi
ehtiyoj/	ehtiyoj	ehtiyo
qay/tishi	qay	qayt
maksimal/	maksimal	maksmal
fevral/da	fevral	fevra
keraklig/ini	keraklig	kerakig
apparat/ining	apparat	apprat
etil/maydigan	etil	et
qator/idan	qator	qatori
o‘yinchoq/	o‘yinchoq	o‘yichoq
ber/ishning	ber	beri
olin/	olin	oln
mutaxassislig/i	mutaxassislig	mutaxassisli
gap/irib	gap	gapi
vaz/ir	vaz	vazi
qara/tgan	qara	qarat
de/ylik	de	del
hamma/ni	hamma	hamm
gaze/taga	gaze	gazet
gaze/ta	gaze	gazet
turkmaniston/	turkmaniston	turkmniston
lig/ini	lig	ligi
tizim/ni	tizim	tizi
tiz/imda	tiz	tizi
ajratil/ayotganini	ajratil	ajrail
ko‘r/satgisi	ko‘r	ko‘ra
haykal/ga	haykal	hayka
ko‘tar/adi	ko‘tar	ko‘tr
min/ta	min	mina
tas/i	tas	tasi
unian/	unian	unia
quruqlik/	quruqlik	quruqik
bu/lar	bu	bua
fevral/gacha	fevral	fevra
bora/yapmiz	bora	boraa
fevral/gacha	fevral	fevra
rake/ta	rake	raket
taomil/lar	taomil	taomi
taomil/larning	taomil	taomi
qonun/dagi	qonun	qonu
ishonchni/ng	ishonchni	ishochi
qo‘riqla/nadi	qo‘riqla	qo‘riql
hok/imning	hok	hoki
qil/inmaydi	qil	qili
ko‘r/satmaslikka	ko‘r	ko‘ra
yakunlan/gach	yakunlan	yakunla
roz/i	roz	rozi
et/tirishga	et	eti
sur/ilgan	sur	surl
bo‘l/masligini	bo‘l	bo‘la
quro/l	quro	qurol
ask/ar	ask	aska
tuga/tiladi	tuga	tugat
xo‘jalik/	xo‘jalik	xo‘jaik
yakun/ida	yakun	yaku
tani/sh	tani	tan
bank/larida	bank	bankl
ko‘r/satmalar	ko‘r	ko‘ra
marra/larimiz	marra	marraa
davlatlararo/	davlatlararo	davlatlarar
ruh/i	ruh	ruhi
milan/ish	milan	mila
jaoma/sini	jaoma	jaom
g‘ol/ib	g‘ol	g‘oli
kir/itdi	kir	kiri
jamoal/ar	jamoal	jamoaar
xirosi/ma	xirosi	xiros
futbol/idagi	futbol	futbo
jamoalar/i	jamoalar	jamoaar
fina/l	fina	final
futbol/i	futbol	futbo
musobaqa/	musobaqa	musobaq
shkvirin/	shkvirin	shkvirn
reglament/iga	reglament	reglment
jamoalar/ga	jamoalar	jamoaar
futbolchi/larning	futbolchi	futbochi
oydon/ga	oydon	oydo
jamoas/ining	jamoas	jamos
futbolchi/lar	futbolchi	futbochi
foz/il	foz	fozi
etish/ib	etish	eth
musobaqa/dagi	musobaqa	musobaq
o‘tadi/gan	o‘tadi	o‘tad
shimoliy/	shimoliy	shimoiy
yo‘lanma/ni	yo‘lanma	yo‘lanm
yo‘qol/ib	yo‘qol	yo‘qo
jamoan/i	jamoan	jamoa
musobaqa/dan	musobaqa	musobaq
musobaqa/da	musobaqa	musobaq
to‘p/lab	to‘p	to‘pl
penalti/lar	penalti	penalt
o‘yin/ida	o‘yin	o‘yi
oldin/ga	oldin	oldi
o‘yin/ga	o‘yin	o‘yi
qozon/	qozon	qozo
qatarlik/	qatarlik	qatarik
finladia/	finladia	finlada
olimpiya/	olimpiya	olmpiya
o‘yin/ini	o‘yin	o‘yi
shamar/i	shamar	shamr
muhammad/	muhammad	muhamad
sot/ilishi	sot	sotl
sot/iladi	sot	sota
futbolchi/lari	futbolchi	futbochi
sot/ilishi	sot	sotl
ol/maslik	ol	ola
jamoas/ini	jamoas	jamos
tailand/	tailand	tailad
masharip/ov	masharip	mashari
yakunl/adi	yakunl	yakun
ter/i	ter	teri
fotomuxb/ir	fotomuxb	fotomuxbir
jahong/ir	jahong	jahog
tek/kanda	tek	teka
tarkibd/	tarkibd	tarkbd
bilamizk/i	bilamizk	bilmizk
xitoylik/lar	xitoylik	xitoyik
ultrabinafsha/	ultrabinafsha	ultrabinasha
rang/ini	rang	rangi
qiz/dirish	qiz	qizi
kuchlanish/dagi	kuchlanish	kuchlansh
tikla/ydi	tikla	tikl
tezlash/tiradi	tezlash	tezlsh
o‘ylaymizk/i	o‘ylaymizk	o‘ylaymik
ko‘r/satmoqda	ko‘r	ko‘ra
karta/siga	karta	kart
chiqarila/	chiqarila	chiqrla
qarabsizk/i	qarabsizk	qarabszk
unutma/ymiz	unutma	unutm
eshi/ta	eshi	esh
erish/ildi	erish	ersh
qil/inmadi	qil	qili
kel/ingani	kel	keli
